20 20
19 1
9 9
OOOOOOOOOOOOOOOOOOOO
O>                <O
O OOOOOOOOOOOOOOOO O
O O<            ^O O
O O OOOOOOOOOOOO O O
O O O          O O O
O O O OOOOOOOO O O O
O O O O      O O O O
O O O O OOOO O O O O
O O O O OGOO O O O O
O O O O O OO O O O O
O O O O O OO O O O O
O O O O O  > O O O O
O O O O OOOOOO O O O
O O O O   v    O O O
O O O OOOOOOOOOO O O
O O O      ^    ^O O
O O OOOOOOOOOOOOOO O
O O^              ^O
O@OOOOOOOOOOOOOOOOOO
